19  18  18  18  18  18  18  26  18  18  18  18  18  18  22
17  32  24  24  16  16  20  0   25  24  24  24  24  32  20
17  20  0   0   17  16  20  0   0   0   0   0   0   17  20
17  20  0   19  16  16  16  26  18  18  18  22  0   17  20
17  16  18  16  16  16  20  0   17  16  16  16  18  16  20
17  16  16  16  16  16  20  0   17  16  16  16  16  16  20
17  16  24  16  24  24  28  0   25  24  24  16  24  16  20
17  20  0   21  0   0   0   0   0   0   0   21  0   17  20
17  16  18  16  18  18  22  0   19  18  18  16  18  16  20
17  16  16  16  16  16  20  0   17  16  16  16  16  16  20
17  16  24  16  16  16  20  0   17  16  16  16  24  16  20
17  20  0   25  24  24  24  26  16  16  16  28  0   17  20
17  20  0   0   0   0   0   0   17  16  20  0   0   17  20
17  32  18  18  18  18  22  0   17  16  16  18  18  32  20
25  24  24  24  24  24  24  26  24  24  24  24  24  24  28


